NO ./textures/N.xpm
SO ./textures/S.xpm
WE ./textures/W.xpm
EA ./textures/E.xpm

F 112,112,112
C 54,57,56




        1111111111111111111111111
        1000000000110000000000001
        1011000001110000000000001
        1001000000000000000000001
111111111011000001110000000000001
100000000011000001110111111111111
11110111111111011100100000001
11110111111111011101100000001
11000000110101011100001000001
10000000000000001100001000001
10000000000000001101011000001
11000001110101011111011000E0111
11110111 1110101 101111000001
11111111 1111111 111111111111